15 24
########################
#K K I I K I I K K K   #
#  #  ## # # ## #  ##  #
#  #  #  # # #  #    # #
#S #  ## # # ## #  ##  #
#EE#  #  # # #  #    # #
#  ## ##  #  ## ## ##  #
#              K       #
#              E       #
#DDDDD  EE  EE E EE EE #
#       EE  EE E EE EE #
#   DD         E   *   #
#TG DD  EE  EE E EE EE #
#%T DD  EE  EE E EE EE #
########################
